# Class #4: Protein design (Part II)

Lysis protein sequence

```jsx
METRFPQQSQQTPASTNRRRPFKHEDYPCRRQQRSSTLYVLIFLAIFLSKFTNQLLLSLLEAVIRTVTTLQQLLT
```

**DNAJ** Sequence

```jsx
MAKQDYYEILGVSKTAEEREIRKAYKRLAMKYHPDRNQGDKEAEAKFKEIKEAYEVLTDSQKRAAYDQYGHAAFEQGGMGGGGFGGGADFSDIFGDVFGDIFGGGRGRQRAARGADLRYNMELTLEEAVRGVTKEIRIPTLEECDVCHGSGAKPGTQPQTCPTCHGSGQVQMRQGFFAVQQTCPHCQGRGTLIKDPCNKCHGHGRVERSKTLSVKIPAGVDTGDRIRLAGEGEAGEHGAPAGDLYVQVQVKQHPIFEREGNNLYCEVPINFAMAALGGEIEVPTLDGRVKLKVPGETQTGKLFRMRGKGVKSVRGGAQGDLLCRVVVETPVGLNERQKQLLQELQESFGGPTGEHNSPRSKSFFDGVKKFFDDLTR 
```

**Amino Acids** list:

- alanine - ala - A
- arginine - arg - R
- asparagine - asn - N
- aspartic acid - asp - D
- cysteine - cys - C
- glutamine - gln - Q
- glutamic acid - glu - E
- glycine - gly - G
- histidine - his - H
- isoleucine - ile - I
- leucine - leu - L
- lysine - lys - K
- methionine - met - M
- phenylalanine - phe - F
- proline - pro - P
- serine - ser - S
- threonine - thr - T
- tryptophan - trp - W
- tyrosine - tyr - Y
- valine - val - V
